1111111111111111111111
1C000000000000000000P1
1011111111111111111111
100C0000000000000000C1
1010111110C01111111101
101C00000000000000C001
1010111111111111111101
101M00000C00000000C001
1011111111111111111101
1E00000000C000000000C1
1111111111111111111111
