11111111111
1P00C000EM1
11111111111
